1111111111111111111111111111
1E0010C0000000000000000CC001
1000111100011111101100001001
1P010000001010001111111C0001
1000011111000010C0C001000001
100C0001000010010C010000CC01
1111111111111111111111111111